NO textures/north.xpm
SO textures/south.xpm
WE textures/west.xpm
EA textures/east.xpm


F 31,31,31
C 0,0,0

111111111111111111111
101000001000000000001
101010101011101110001
100010100010000010001
101010101111101011101
100000101000101000001
101111101011101111101
101000000010100000101
101011111010111110101
101010001010100010101
101010101010101010101
100000101010001010001
101111101011111011101
100000101000100010001
101110101110101110111
101000100000100010101
101011111111111010101
100010000000000010001
101010111011111111101
1N1000001000000000001
111111111111111111111
